vv<<<<<<<<<<<<<<<s<<<<<<<<<<<<<<<<<<
vv<<<<<<<<<<<<<<<s<<<<<<<<<<<<<<<<<<
vvT#^T##^##TvvTSST#T#T#T#T#T#D#T#T^^
vv#T^#DT^T##vv#^^<<<<<<<<<<<<<<<<<^^
vv>>>>>>>>>>vvT^^<<<<<<^<<<<<<<<<<^^
vv#Dv#v#^#v#vv#^^T##D##T^vT######T^^
vv##v#v#^Dv#vvT^^>>>>>>>>>v>>>>>>>^^
vv<<<<<<<<v<vv#^^>>>>>>>>>>>>>>>>>^^
vv#Dv#D##Tv#vvT^^####vv##D##vv##D#^^
vv>>>>>>>>v>vv#^^DRT#vv#RTR#vv#RR#^^
vvT#vT#D#Tv#vvT^^T###SS#####SST###^^
vv<<<<<<<<<<<<<<<<<<<<<s<<<<<vs<<<^^
vv<<<<<<<<<<<<<<^<<<<<<s<<<<<<s<<<^^
vv#vv#^^###vv###^^##########vv###T^^
vvTvvT^^#RDvv#R#^^#TRTRRTRT#vv#RR#^^
vv#vv#^^###vv###^^###D######SST###^^
vv>>>s>>>>>>>v>>>^>>>>>>>>>s>>>>>s^^
vv>>>s^>>>>>>>>^>>>>>>>>>>>s>>>>>s^^
vv#vv#SS###Tvv#^^####vvT###Tvv####SS
vvTvv#^^DRR#vvT^^#TRDvv#RTR#vv#TR#^^
vvTvv#^^#RR#vvT^^#RT#vv#RRTDvv#RT#^^
vv#vv#^^#D#Tvv#^^####vvT####SS####^^
vv<<<<<<<<<<<v<^<<<<<<<<<<<<<vs<<<^^
vv<<<<<<<<<v<<<<<^<<<<<<<<<<<<s<<<^^
vv#D#######vv###^^T######D#Tvv##DT^^
vv#TRTRTRT#vv#v#^^#RTRTRRTR#vv#RR#^^
vv####D####vv###^^T#D######TSS###T^^
vv>>>s>>>>>>>>>>>^>>>>>>>>>sv>>>>s^^
vv>>>s>>>>>>>>>^>>>>>>>>>>>s>>>>>s^^
vv####SS####vvT^^#####vTD##TvvT##TSS
vv#RT#^^DRT#vv#^^#TRT#v#RRR#vv#RR#^^
vv#TR#^^#TR#vv#^^#TRTDv#RRR#vv#RR#^^
vv####^^####SST^^#####vT###TSST#D#^^
>>>>>>>>>>>s>>>>>>>>>>>>>>>s>>>>>>^^
>>>>>>>>>>>s>>>>>>>>>>>>>>>s>>>>>>^^